PPPPPPPPPPPPPPPP
P211P111111P112P
P1P1P1PPPP1P1P1P
P1P111111111111P
P1P1PPPPPPPP1P1P
P1P1P000000P1P1P
P1P1111111111P1P
P1P1P1PPP1PP1P1P
P1P1P111311P111P
P1P1PPP1PP1P1P1P
P1P11111111P111P
P111PPPPPPPP1P1P
P1P1111O11111P1P
P1P1P1PPPPPP1P1P
P211P1111111112P
PPPPPPPPPPPPPPPP