PPPPPPPPPPPPPPPP
P21111111111112P
P1PPPPPPPPPPPP1P
P1P1111111131P1P
P1P1PPPPPPPP1P1P
P1P1P000000P1P1P
P1P1111111111P1P
P1P1P1PPP1PP1P1P
P1P1P111111P111P
P1P1PPP1PP1P1P1P
P1P11111111P111P
P111PPPPPPPP1P1P
P1P1111O11111P1P
P1PPPPPPPPPPPP1P
P21111111111112P
PPPPPPPPPPPPPPPP